NAME HUB
SIZE 32 32
A_CODE S 56
A_CODE O 63
A_CODE D 62


A_CODE ^ 16
A_CODE v 17
A_CODE < 18
A_CODE > 19

G_CODE 9 63
G_CODE 7 62
G_CODE 5 26
G_CODE 4 464
G_CODE 3 83
G_CODE 2 443
G_CODE 1 82
G_CODE \ 109

BODY
O7O2O2O2O2O2O2O2O2O2O2O2O2O2O2O2O2O2O2O2O2O2O2O2O2O2O2O2O2O2O2O9
O4O5O5O5O4<\<\ 5 5 5 5 5 5 5 5 5 5 5 5 5 5 5 5 5 5v\v\O4O5O5O5O4
O4O5O5O4<\<\ 5 5 5 5 5 5 5 5 5 5 5 5 5 5 5 5 5 5 5 5v\v\O4O5O5O4
O4O5O4<\<\ 5 5 5 5 5 5 5 5 5 5 5 5 5 5 5 5 5 5 5 5 5 5v\v\O4O5O4
O4O4<\<\ 5 5 5 5 5 5 5 5 5 5 5 5 5 5 5 5 5 5 5 5 5 5 5 5v\v\O4O4
O4<\<\ 5 5 5 5 5 5 5 5 5 5 5 5 5 5 5 5 5 5 5 5 5 5 5 5 5 5v\v\O4
O4<\ 5 5 5 5 5 5 5 5 5 5 5 5 5 5 5 5 5 5 5 5 5 5 5 5 5 5 5 5v\O4
O4 5 5 5 5 5 5 5 5 5 5 5 5 5 5 5 5 5 5 5 5 5 5 5 5 5 5 5 5 5 5O4
O4 5 5 5 5 5 5 5 5O2O2O2O2 5 5 5 5 5O4 5 5 5 5 5 5 5 5 5 5 5 5O4
O4 5 5 5 5 5 5 5 5O4 5 5 5O4 5 5 5O2O4 5 5 5 5 5 5 5 5 5 5 5 5O4
O4 5 5 5 5 5 5 5 5O4 5 5 5O4 5 5O2 5O4 5 5 5 5 5 5 5 5 5 5 5 5O4
O4 5 5 5 5 5 5 5 5O4 5 5 5O4 5 5 5 5O4 5 5 5 5 5 5 5 5 5 5 5 5O4
O4 5 5 5 5 5 5 5 5O4 5 5 5O4 5 5 5 5O4 5 5 5 5 5 5 5 5 5 5 5 5O4
O4 5 5 5 5 5 5 5 5O2O2O2O2 5 5 5 5 5O4 5 5 5 5 5 5 5 5 5 5 5 5O4
O4 5 5 5 5 5 5 5 5 5 5 5 5 5 5 5 5 5 5 5 5 5 5 5 5 5 5 5 5 5 5O4
O4 5 5 5 5 5 5 5 5 5 5 5 5 5 5 5 5 5 5 5 5 5 5 5 5 5 5 5 5 5 5O4
O4 5 5 5 5 5 5 5 5 5 5 5 5 5 5 5 5 5 5 5 5 5 5 5 5 5 5 5 5 5 5O4
O4 5 5 5 5 5 5 5 5 5 5 5 5 5 5 5 5 5 5 5 5 5 5 5 5 5 5 5 5 5 5O4
O4 5 5 5 5 5 5 5 5 5 5 5 5 5 5 5 5 5 5 5 5 5 5 5 5 5 5 5 5 5 5O4
O4 5 5 5 5 5 5 5 5 5 5 5 5 5 5 5 5 5 5 5 5 5 5 5 5 5 5 5 5 5 5O4
O4 5 5 5 5 5 5 5 5 5 5 5 5 5 5 5 5 5 5 5 5 5 5 5 5 5 5 5 5 5 5O4
O4 5 5 5 5 5 5 5 5 5 5 5 5 5 5 5 5 5 5 5 5 5 5 5 5 5 5 5 5 5 5O4
O4 5 5 5 5 5 5 5 5 5 5 5 5 5 5 5 5 5 5 5 5 5 5 5 5 5 5 5 5 5 5O4
O4 5 5 5 5 5 5 5 5 5 5 5 5 5 5 5 5 5 5 5 5 5 5 5 5 5 5 5 5 5 5O4
O4 5 5 5 5 5 5 5 5 5 5 5 5 5 5 5 5 5 5 5 5 5 5 5 5 5 5 5 5 5 5O4
O4^\ 5 5 5 5 5 5 5 5 5 5 5 5 5 5 5 5 5 5 5 5 5 5 5 5 5 5 5 5>\O4
O4^\^\ 5 5 5 5 5 5 5 5 5 5 5 5 5 5 5 5 5 5 5 5 5 5 5 5 5 5>\>\O4
O4O4^\^\ 5 5 5 5 5 5 5 5 5 5 5 5 5 5 5 5 5 5 5 5 5 5 5 5>\>\O4O4
O4O5O4^\^\ 5 5 5 5 5 5 5 5 5 5 5 5 5 5 5 5 5 5 5 5 5 5>\>\O4O5O4
O4O5O5O4^\^\ 5 5 5 5 5 5 5 5 5S5 5 5 5 5 5 5 5 5 5 5>\>\O4O5O5O4
O4O5O5O5O4^\^\ 5 5 5 5 5 5 5 5 5 5 5 5 5 5 5 5 5 5>\>\O4O5O1O5O4
O1O2O2O2O2O2O2O2O2O2O2O2O2O2O2O2O2O2O2O2O2O2O2O2O2O2O2O2O2O2O2O3
Legend:
O - Obstacle
D - Door
S - Player Spawn
