NAME HUB
SIZE 16 32
A_CODE S 56
A_CODE O 63
A_CODE D 62
G_CODE 9 63
G_CODE 7 62
G_CODE 5 26
G_CODE 4 464
G_CODE 3 83
G_CODE 2 443
G_CODE 1 82
BODY
O7O2O2O2O2O2O2O2O2O2O2O2O2O2O2O9
O4 5 5 5 5 5 5 5 5 5 5 5 5 5 5O4
O4 5 5 5 5 5 5>1 5 5 5 5 5 5 5O4
O4 5 5 5 5 5 5 5 5 5 5 5 5 5 5O4
O4 5 5 5 5 5 5 5 5 5 5 5 5 5 5O4
O4 5 5 5 5 5 5 5 5 5 5 5 5 5 5O4
O7O2O2O2O3O2O2DHD5O2O2O2O2O2O2O4
O4 5 5 5D5 5 5 5 5 5 5 5 5 5 5O4
O4{4 5 5DV 5 5 5 5 5 5 5 5 5 5O4
O1O2O2O2O9 5 5 5 5 5 5 5 5 5 5O4
 0 0 0 0O4 5 5 5 5 5 5 5 5 5 5O4
 0 0 0 0O4 5 5 5 5 5 5 5 5 5 5O4
O7O2O2O2O3 5 5 5 5 5 5 5 5 5 5O4
O4 5 5 5D5 5 5 5 5 5 5 5 5 5 5O4
O4{3 5 5DV 5 5 5 5 5 5 5 5 5 5O4
O1O2O2O2O9 5 5 5 5 5 5 5 5 5 5O4
 0 0 0 0O4 5 5 5 5 5 5 5 5 5 5O4
 0 0 0 0O4 5 5 5 5 5 5T5 5 5 5O4
O7O2O2O2O3 5 5 5 5 5 5 5 5 5 5O4
O4 5 5 5D5 5 5 5 5 5 5 5 5 5 5O4
O4{2 5 5DV 5 5 5 5 5 5 5 5 5 5O4
O1O2O2O2O9 5 5 5 5 5 5 5 5 5 5O4
 0 0 0 0O4 5 5 5 5 5 5 5 5 5 5O4
 0 0 0 0O4 5 5 5 5 5 5 5 5 5 5O4
O7O2O2O2O3 5 5 5 5 5 5 5 5 5 5O4
O4 5 5 5D5 5 5A5 5 5 5 5 5 5 5O4
O4{1 5 5DV 5 5 5 5 5 5T5 5 5 5O4
O1O2O2O2O9 5 5 5 5 5 5 5 5 5 5O4
 0 0 0 0O4 5 5 5 5 5 5 5 5 5 5O4
 0 0 0 0O4 5 5<1 5 5 5S5 5 5 5O4
 0 0 0 0O4 5 5 5 5 5 5 5 5 5 5O4
 0 0 0 0O1O2O2O2O2O2O2O2O2O2O2O3
Legend:
O - Obstacle
D - Door
S - Player Spawn