MAP.NAME HUB
MAP.WIDTH 16
MAP.HEIGHT 32
MAP.BODY
O7O2O2O2O2O2O2O2O2O2O2O2O2O2O2O9
O4 5 5 5 5 5 5 5 5 5 5 5 5 5 5O4
O4 5 5 5 5 5 5>1 5 5 5 5 5 5 5O4
O4 5 5 5 5 5 5 5 5 5 5 5 5 5 5O4
O4 5 5 5 5 5 5 5 5 5 5 5 5 5 5O4
O4 5 5 5 5 5 5 5 5 5 5 5 5 5 5O4
O7O2O2O2O3 5 5 5 5 5 5 5 5 5 5O4
O4 5 5 5 5 5 5 5 5 5 5 5 5 5 5O4
O4 5 5 5DV 5 5 5 5 5 5 5 5 5 5O4
O1O2O2O2O9 5 5 5 5 5 5 5 5 5 5O4
 0 0 0 0O4 5 5 5 5 5 5 5 5 5 5O4
 0 0 0 0O4 5 5 5 5 5 5 5 5 5 5O4
O7O2O2O2O3 5 5 5 5 5 5 5 5 5 5O4
O4 5 5 5 5 5 5 5 5 5 5 5 5 5 5O4
O4 5 5 5DV 5 5 5 5 5 5 5 5 5 5O4
O1O2O2O2O9 5 5 5 5 5 5 5 5 5 5O4
 0 0 0 0O4 5 5 5 5 5 5 5 5 5 5O4
 0 0 0 0O4 5 5 5 5 5 5 5 5 5 5O4
O7O2O2O2O3 5 5 5 5 5 5 5 5 5 5O4
O4 5 5 5 5 5 5 5 5 5 5 5 5 5 5O4
O4 5 5 5DV 5 5 5 5 5 5 5 5 5 5O4
O1O2O2O2O9 5 5 5 5 5 5 5 5 5 5O4
 0 0 0 0O4 5 5 5 5 5 5 5 5 5 5O4
 0 0 0 0O4 5 5 5 5 5 5 5 5 5 5O4
O7O2O2O2O3 5 5 5 5 5 5 5 5 5 5O4
O4 5 5 5 5 5 5 5 5 5 5 5 5 5 5O4
O4 5 5 5DV 5 5 5 5 5 5 5 5 5 5O4
O1O2O2O2O9 5 5<1 5 5 5 5 5 5 5O4
 0 0 0 0O4 5 5 5 5 5 5 5 5 5 5O4
 0 0 0 0O4 5 5 5 5 5 5 5 5 5 5O4
 0 0 0 0O4 5 5 5 5 5 5 5 5 5 5O4
 0 0 0 0O1O2O2O2O2O2O2O2O2O2O2O3
O - Obstacle
S - Spawn point
D - Door (V - Vertical, H - Horizontal)
> - Teleport Entrance (Number - Number of pair)
< - Teleport Exit (Number - Number of pair)